15 1 22 36 29 43 50 8 
23 16 9 30 2 44 37 50 
38 17 45 31 24 10 3 50 
46 4 11 32 50 18 25 39 
33 5 12 40 47 50 19 26 
48 50 13 27 20 6 34 41 
21 14 49 50 35 42 7 28 
14 38 44 51 26 20 1 32 
45 2 33 21 8 51 27 39 
15 46 40 34 3 9 51 28 
51 41 10 4 47 22 16 35 
48 17 23 51 29 11 42 5 
51 49 36 24 18 12 30 6 
43 13 51 37 25 7 19 31 
18 52 23 1 35 13 40 45 
24 14 29 19 46 2 41 52 
30 8 42 20 47 52 3 25 
52 4 31 48 26 36 9 21 
27 15 32 10 5 52 37 49 
38 16 11 33 52 6 43 28 
34 12 7 39 17 44 52 22 
53 42 12 46 16 27 31 1 
2 17 36 47 28 53 13 32 
33 18 3 22 37 53 48 14 
23 34 53 49 8 19 4 38 
5 39 53 9 24 43 35 20 
10 21 29 44 6 25 40 53 
53 45 41 15 7 26 11 30 
11 1 34 37 21 47 54 24 
54 2 15 48 38 35 25 12 
3 16 54 39 49 29 26 13 
30 43 54 4 17 27 40 14 
54 44 41 5 28 18 31 8 
32 45 6 19 22 54 42 9 
54 33 10 36 7 20 23 46 
10 28 48 1 19 30 55 39 
22 31 20 2 55 11 49 40 
21 41 23 12 32 43 3 55 
44 24 4 13 42 55 33 15 
34 36 16 55 14 45 5 25 
46 6 55 26 35 17 37 8 
9 27 18 47 7 29 55 38 
41 33 1 17 9 49 25 56 
34 10 56 2 43 42 26 18 
11 3 35 56 44 27 19 36 
45 56 12 20 37 29 28 4 
13 5 56 21 22 46 38 30 
47 6 56 39 15 31 14 23 
7 24 48 16 32 40 56 8 
1 5 3 6 7 4 57 2 
11 57 14 12 8 10 9 13 
18 17 57 16 19 15 20 21 
24 57 23 22 27 28 25 26 
57 33 34 29 32 30 35 31 
40 36 37 38 57 41 39 42 
47 49 45 48 46 44 43 57 
52 54 50 55 51 53 57 56 
