45 13 6 23 18 35 57 40
17 11 48 23 7 42 36 54
39 43 41 38 8 40 37 42
20 49 11 3 40 31 51 29
31 38 10 17 24 45 52 1
56 7 13 50 31 37 19 25
31 33 32 34 30 35 36 8
27 42 16 31 57 12 5 46
1 12 54 40 33 47 19 26
10 49 22 37 6 27 32 54
33 49 9 25 2 57 17 41
57 44 38 20 14 32 7 26
18 46 39 25 11 1 53 32
3 47 56 38 9 18 27 36
17 14 40 30 4 50 53 27
21 31 43 48 9 26 6 53
41 24 46 36 14 51 19 6
28 13 47 5 51 17 43 32
15 26 3 55 35 17 37 46
47 55 31 22 2 39 14 23
3 16 25 45 54 34 43 14
5 30 11 26 56 41 45 22
56 28 42 21 35 49 1 14
38 34 23 15 5 19 53 49
13 9 8 10 15 12 14 11
48 24 32 56 40 16 2 15
37 2 20 53 36 12 28 45
17 20 22 16 21 8 19 18
28 41 15 4 31 18 54 44
24 30 49 55 7 12 18 43
8 1 3 2 4 7 6 5
2 43 11 27 35 19 52 44
42 3 53 24 13 44 33 22
15 21 33 7 27 51 39 45
51 54 52 8 56 57 55 53
26 8 23 29 27 24 28 25
10 4 46 43 56 23 33 20
39 4 49 26 16 36 52 13
34 9 40 7 22 46 52 28
1 37 30 16 23 9 51 44
29 53 47 41 10 7 35 16
45 55 42 19 29 4 9 32
48 8 50 44 47 45 46 49
30 28 19 3 57 39 10 48
29 46 2 13 30 38 54 21
41 20 34 1 55 48 27 13
2 42 18 50 10 51 34 26
47 20 25 42 30 52 6 15
15 22 1 57 50 36 29 43
40 44 55 36 10 5 25 21
21 50 3 32 41 52 23 12
34 6 29 56 17 44 39 12
25 51 22 35 38 12 48 4
54 39 9 24 5 35 50 20
11 24 4 57 34 21 37 47
37 48 18 14 33 52 29 5
33 11 50 55 28 6 38 16
