4 36 39 16 49 26 13 52
12 42 16 27 46 31 57 5
28 32 43 51 5 17 47 13
18 22 16 19 17 21 8 20
29 44 34 12 39 56 6 17
28 2 45 12 36 20 53 37
24 49 30 12 18 7 55 43
17 33 25 49 57 9 2 41
2 35 11 43 27 19 44 52
50 55 16 33 11 38 28 6
48 16 32 2 24 40 15 56
50 3 12 32 21 52 41 23
20 27 55 1 48 34 41 13
42 48 17 7 11 54 36 23
53 6 48 43 31 21 9 26
41 38 8 43 39 42 40 37
11 57 37 34 21 47 4 24
2 4 6 3 5 1 7 8
20 35 50 54 39 9 5 24
39 57 28 3 30 19 48 10
40 3 29 51 49 31 11 20
22 24 53 33 42 44 3 13
37 6 27 49 54 32 22 10
9 19 55 29 45 4 42 32
53 17 4 27 30 40 14 50
31 45 1 52 10 17 24 38
37 48 5 33 52 29 14 18
33 10 20 56 23 46 4 43
25 28 24 29 23 26 27 8
55 26 35 15 3 37 17 46
49 42 35 56 21 14 28 1
32 34 35 36 8 33 30 31
49 38 5 15 19 23 53 34
36 9 27 56 18 3 38 47
29 53 16 47 7 35 10 41
51 34 2 18 26 42 10 50
7 33 15 51 45 27 39 21
41 22 30 45 26 5 56 11
31 19 50 7 37 13 25 56
22 46 34 28 52 7 9 40
19 24 6 14 46 51 36 41
38 4 35 22 25 51 12 48
12 54 33 19 47 40 26 1
14 45 16 54 25 34 3 43
8 12 11 13 14 9 15 10
46 50 48 47 45 44 49 8
18 11 53 1 32 46 39 25
44 14 20 32 38 7 57 26
37 30 1 44 16 51 23 9
54 30 46 29 13 38 21 2
43 15 36 29 50 1 57 22
57 45 6 23 13 40 35 18
47 52 6 25 20 42 30 15
8 54 55 51 53 52 57 56
36 40 25 21 44 5 55 10
54 15 41 18 4 44 31 28
47 14 23 55 39 22 31 2
